肮	肮 骯
袄	袄 襖
爱	爱 愛
庵	庵 菴
奥	奥 奧
碍	碍 礙
蔼	蔼 藹
埯	埯 垵
铵	铵 銨
皑	皑 皚
谙	谙 諳
锕	锕 錒
腌	腌 醃
媪	媪 媼
骜	骜 驁
鹌	鹌 鵪
嗳	嗳 噯
嫒	嫒 嬡
叆	叆 靉
暧	暧 曖
翱	翱 翺
鳌	鳌 鰲
霭	霭 靄
岙	岙 嶴
垵	垵 埯
瑷	瑷 璦
锿	锿 鎄
卜	卜 蔔
贝	贝 貝
币	币 幣
办	办 辦
布	布 佈
边	边 邊
毕	毕 畢
闭	闭 閉
并	并 並 竝
坝	坝 壩
报	报 報
别	别 彆
狈	狈 狽
补	补 補
驳	驳 駁
表	表 錶
拨	拨 撥
杯	杯 盃
板	板 闆
败	败 敗
贬	贬 貶
备	备 備
饱	饱 飽
变	变 變
宝	宝 寶
绊	绊 絆
帮	帮 幫
标	标 標
饼	饼 餅
绑	绑 綁
毙	毙 斃
罢	罢 罷
笔	笔 筆
颁	颁 頒
宾	宾 賓
剥	剥 剝
绷	绷 綳
辈	辈 輩
惫	惫 憊
谤	谤 謗
编	编 編
摆	摆 擺 襬
鲍	鲍 鮑
禀	禀 稟
痹	痹 痺
滨	滨 濱
辟	辟 闢
缤	缤 繽
镑	镑 鎊
瘪	瘪 癟
辩	辩 辯
濒	濒 瀕
辫	辫 辮
鳖	鳖 鱉
鬓	鬓 鬢
呗	呗 唄
贲	贲 賁
荜	荜 蓽
哔	哔 嗶
钚	钚 鈈
钡	钡 鋇
钣	钣 鈑
钯	钯 鈀
鸨	鸨 鴇
飑	飑 颮
钵	钵 鉢
钹	钹 鈸
铂	铂 鉑
铋	铋 鉍
饽	饽 餑
笾	笾 籩
鹁	鹁 鵓
筚	筚 篳
傧	傧 儐
摈	摈 擯
龅	龅 齙
跸	跸 蹕
锛	锛 錛
鲅	鲅 鮁
滗	滗 潷
槟	槟 檳
殡	殡 殯
膑	膑 臏
镔	镔 鑌
飙	飙 飆
镖	镖 鏢
镚	镚 鏰
鳊	鳊 鯿
鞴	鞴 韝
髌	髌 髕
鳔	鳔 鰾
镳	镳 鑣
诐	诐 詖
骉	骉 驫
袯	袯 襏
赑	赑 贔
鹎	鹎 鵯
鲌	鲌 鮊
镈	镈 鎛
鲾	鲾 鰏
厂	厂 廠
才	才 纔
车	车 車
长	长 長
从	从 從
仓	仓 倉
丑	丑 醜
丛	丛 叢
册	册 冊
处	处 處
出	出 齣
场	场 場
尘	尘 塵
虫	虫 蟲
吃	吃 喫
传	传 傳
创	创 創
冲	冲 衝
产	产 産
闯	闯 闖
驰	驰 馳
苍	苍 蒼
财	财 財
囱	囱 囪
彻	彻 徹
肠	肠 腸
床	床 牀
灿	灿 燦
沧	沧 滄
词	词 詞
层	层 層
迟	迟 遲
陈	陈 陳
纯	纯 純
厕	厕 厠
齿	齿 齒
畅	畅 暢
侧	侧 側
采	采 採
宠	宠 寵
诚	诚 誠
衬	衬 襯
参	参 參
残	残 殘
尝	尝 嚐 嘗
钞	钞 鈔
疮	疮 瘡
测	测 測
蚕	蚕 蠶
耻	耻 恥
唇	唇 脣
础	础 礎
称	称 稱
舱	舱 艙
掺	掺 摻
铲	铲 鏟
偿	偿 償
凑	凑 湊
阐	阐 闡
惭	惭 慚
惨	惨 慘
绰	绰 綽
绸	绸 綢
搀	搀 攙
葱	葱 蔥
厨	厨 廚
畴	畴 疇
赐	赐 賜
锄	锄 鋤
储	储 儲
惩	惩 懲
馋	馋 饞
窜	窜 竄
禅	禅 禪
酬	酬 酧
错	错 錯
锤	锤 錘
辞	辞 辭
筹	筹 籌
触	触 觸
雏	雏 雛
痴	痴 癡
缠	缠 纏
蝉	蝉 蟬
撑	撑 撐
聪	聪 聰
澄	澄 澂
橱	橱 櫥
颤	颤 顫
刍	刍 芻
伥	伥 倀
伧	伧 傖
忏	忏 懺
苌	苌 萇
苁	苁 蓯
饬	饬 飭
怅	怅 悵
怆	怆 愴
枨	枨 棖
枞	枞 樅
钏	钏 釧
钗	钗 釵
侪	侪 儕
诧	诧 詫
绌	绌 絀
柽	柽 檉
砗	砗 硨
虿	虿 蠆
觇	觇 覘
俦	俦 儔
炽	炽 熾
恻	恻 惻
莼	莼 蒓
龀	龀 齔
鸱	鸱 鴟
谄	谄 諂
骋	骋 騁
蛏	蛏 蟶
铳	铳 銃
阊	阊 閶
谌	谌 諶
谗	谗 讒
婵	婵 嬋
骖	骖 驂
棰	棰 箠
辍	辍 輟
锉	锉 銼
馇	馇 餷
碜	碜 磣
辏	辏 輳
鹑	鹑 鶉
踌	踌 躊
锸	锸 鍤
鹚	鹚 鷀
骢	骢 驄
撺	撺 攛
龊	龊 齪
骣	骣 驏
鲳	鲳 鯧
镩	镩 鑹
雠	雠 讎
蹰	蹰 躕
蹿	蹿 躥
镲	镲 鑔
谶	谶 讖
黪	黪 黲
镵	镵 鑱
玚	玚 瑒
刬	刬 剗
鸧	鸧 鶬
浐	浐 滻
帱	帱 幬
梼	梼 檮
铖	铖 鋮
蒇	蒇 蕆
赪	赪 赬
榇	榇 櫬
缞	缞 縗
澂	澂 澄
鹾	鹾 鹺
鲿	鲿 鱨
酂	酂 酇
冁	冁 囅
斗	斗 鬥
订	订 訂
队	队 隊
邓	邓 鄧
东	东 東
电	电 電
冬	冬 鼕
对	对 對
动	动 動
夺	夺 奪
达	达 達
当	当 當 噹
丢	丢 丟
灯	灯 燈
导	导 導
吨	吨 噸
钉	钉 釘
岛	岛 島
冻	冻 凍
兑	兑 兌
担	担 擔
顶	顶 頂
抵	抵 牴 觝
钓	钓 釣
迭	迭 疊
单	单 單
诞	诞 誕
挡	挡 擋
垫	垫 墊
带	带 帶
荡	荡 蕩
栋	栋 棟
点	点 點
钝	钝 鈍
贷	贷 貸
胆	胆 膽
独	独 獨
捣	捣 搗
档	档 檔
顿	顿 頓
党	党 黨
敌	敌 敵
递	递 遞
涤	涤 滌
读	读 讀
铛	铛 鐺
盗	盗 盜
断	断 斷
淀	淀 澱
谍	谍 諜
祷	祷 禱
弹	弹 彈
堕	堕 墮
堤	堤 隄
赌	赌 賭
缎	缎 緞
缔	缔 締
叠	叠 曡
锻	锻 鍛
镀	镀 鍍
端	端 耑
颠	颠 顛
雕	雕 彫
巅	巅 巔
凼	凼 氹
诋	诋 詆
砀	砀 碭
籴	籴 糴
炖	炖 燉
垱	垱 壋
笃	笃 篤
胨	胨 腖
怼	怼 懟
珰	珰 璫
鸫	鸫 鶇
趸	趸 躉
钿	钿 鈿
铎	铎 鐸
郸	郸 鄲
焘	焘 燾
掸	掸 撣
啖	啖 啗
铫	铫 銚
阇	阇 闍
渎	渎 瀆
惮	惮 憚
裆	裆 襠
谛	谛 諦
椟	椟 櫝
殚	殚 殫
赕	赕 賧
犊	犊 犢
牍	牍 牘
谠	谠 讜
跶	跶 躂
锝	锝 鍀
锭	锭 錠
煅	煅 煆
窦	窦 竇
箪	箪 簞
鞑	鞑 韃
镝	镝 鏑
鲷	鲷 鯛
镦	镦 鐓
镫	镫 鐙
簖	簖 籪
鲽	鲽 鰈
黩	黩 黷
癫	癫 癲
轪	轪 軑
岽	岽 崬
饳	饳 飿
绐	绐 紿
垯	垯 墶
荙	荙 薘
哒	哒 噠
耑	耑 端
钭	钭 鈄
绖	绖 絰
鱽	鱽 魛
窎	窎 窵
铞	铞 銱
铥	铥 銩
觌	觌 覿
筜	筜 簹
瘅	瘅 癉
叇	叇 靆
亸	亸 嚲
儿	儿 兒
尔	尔 爾
讹	讹 訛
贰	贰 貳
饵	饵 餌
恶	恶 惡
饿	饿 餓
鹅	鹅 鵝
额	额 額
鳄	鳄 鰐
轭	轭 軛
迩	迩 邇
垩	垩 堊
鸸	鸸 鴯
铒	铒 鉺
阏	阏 閼
谔	谔 諤
锇	锇 鋨
腭	腭 齶
鹗	鹗 鶚
锷	锷 鍔
颚	颚 顎
鲕	鲕 鮞
飞	飞 飛
丰	丰 豐
风	风 風
凤	凤 鳳
冯	冯 馮
发	发 髮 發
仿	仿 倣
负	负 負
讽	讽 諷
访	访 訪
妇	妇 婦
抚	抚 撫
坟	坟 墳
佛	佛 彿
饭	饭 飯
泛	泛 汎
纷	纷 紛
纺	纺 紡
范	范 範
枫	枫 楓
矾	矾 礬
奋	奋 奮
贩	贩 販
肤	肤 膚
废	废 廢
罚	罚 罰
复	复 復 複
疯	疯 瘋
阀	阀 閥
费	费 費
俯	俯 頫
烦	烦 煩
诽	诽 誹
辅	辅 輔
赋	赋 賦
锋	锋 鋒
粪	粪 糞
愤	愤 憤
辐	辐 輻
缚	缚 縛
缝	缝 縫
翻	翻 繙
讣	讣 訃
凫	凫 鳬
呒	呒 嘸
沣	沣 灃
沨	沨 渢
钒	钒 釩
绂	绂 紱
驸	驸 駙
珐	珐 琺
砜	砜 碸
钫	钫 鈁
麸	麸 麩
偾	偾 僨
绯	绯 緋
鲂	鲂 魴
鲋	鲋 鮒
赙	赙 賻
幞	幞 襆
鲱	鲱 鯡
鲼	鲼 鱝
绋	绋 紼
韨	韨 韍
赗	赗 賵
镄	镄 鐨
豮	豮 豶
干	干 幹 乾
个	个 個
广	广 廣
冈	冈 岡
归	归 歸
巩	巩 鞏
过	过 過
轨	轨 軌
刚	刚 剛
关	关 關
观	观 觀
贡	贡 貢
岗	岗 崗
谷	谷 榖
龟	龟 龜
沟	沟 溝
纲	纲 綱
规	规 規
拐	拐 枴 柺
柜	柜 櫃
构	构 構
国	国 國
购	购 購
刮	刮 颳
秆	秆 稈
诡	诡 詭
该	该 該
贯	贯 貫
挂	挂 掛
贵	贵 貴
钙	钙 鈣
钢	钢 鋼
钩	钩 鈎
闺	闺 閨
阁	阁 閣
宫	宫 宮
给	给 給
赶	赶 趕
贾	贾 賈
顾	顾 顧
硅	硅 矽
鸽	鸽 鴿
够	够 夠
馆	馆 館
盖	盖 蓋
惯	惯 慣
搁	搁 擱
锅	锅 鍋
尴	尴 尷
滚	滚 滾
管	管 琯
镐	镐 鎬
赣	赣 贛
亘	亘 亙
犷	犷 獷
诂	诂 詁
妫	妫 嬀
匦	匦 匭
刿	刿 劌
刽	刽 劊
诖	诖 詿
诟	诟 詬
绀	绀 紺
轱	轱 軲
剐	剐 剮
饹	饹 餎
诰	诰 誥
埚	埚 堝
鸪	鸪 鴣
桧	桧 檜
赅	赅 賅
钴	钴 鈷
皋	皋 臯
衮	衮 袞
绠	绠 綆
掴	掴 摑
掼	掼 摜
龚	龚 龔
蛊	蛊 蠱
帼	帼 幗
铬	铬 鉻
鸹	鸹 鴰
馃	馃 餜
绲	绲 緄
琯	琯 管
椁	椁 槨
辊	辊 輥
锆	锆 鋯
鹄	鹄 鵠
赓	赓 賡
缑	缑 緱
毂	毂 轂
锢	锢 錮
缟	缟 縞
觏	觏 覯
榖	榖 谷
蝈	蝈 蟈
鹘	鹘 鶻
鲑	鲑 鮭
镉	镉 鎘
鲠	鲠 鯁
鲧	鲧 鯀
鲴	鲴 鯝
鳏	鳏 鰥
鳜	鳜 鱖
鹳	鹳 鸛
戆	戆 戇
钆	钆 釓
唝	唝 嗊
腘	腘 膕
馉	馉 餶
鹒	鹒 鶊
鬶	鬶 鬹
鳡	鳡 鱤
户	户 戶
号	号 號
汇	汇 匯 彙
汉	汉 漢
划	划 劃
回	回 迴
华	华 華
伙	伙 夥
后	后 後
会	会 會
合	合 閤
讳	讳 諱
欢	欢 歡
红	红 紅
坏	坏 壞
护	护 護
还	还 還
沪	沪 滬
怀	怀 懷
环	环 環
画	画 畫
轰	轰 轟
货	货 貨
话	话 話
挥	挥 揮
荤	荤 葷
胡	胡 鬍
哗	哗 嘩
浑	浑 渾
诲	诲 誨
贺	贺 賀
绘	绘 繪
骇	骇 駭
换	换 換
壶	壶 壺
获	获 獲 穫
桦	桦 樺
唤	唤 喚
贿	贿 賄
涣	涣 渙
黄	黄 黃
秽	秽 穢
焊	焊 釬 銲
焕	焕 煥
鸿	鸿 鴻
谎	谎 謊
祸	祸 禍
韩	韩 韓
辉	辉 輝
痪	痪 瘓
缓	缓 緩
毁	毁 毀 燬
横	横 橫
鹤	鹤 鶴
讧	讧 訌
纥	纥 紇
奂	奂 奐
闳	闳 閎
诃	诃 訶
诙	诙 詼
诨	诨 諢
顸	顸 頇
荟	荟 薈
咴	咴 噅
饸	饸 餄
阂	阂 閡
浒	浒 滸
骅	骅 驊
绗	绗 絎
珲	珲 琿
蚝	蚝 蠔
颃	颃 頏
烩	烩 燴
铧	铧 鏵
铪	铪 鉿
鸻	鸻 鴴
馄	馄 餛
阍	阍 閽
颌	颌 頜
翚	翚 翬
颔	颔 頷
阖	阖 闔
鲎	鲎 鱟
鹕	鹕 鶘
鲩	鲩 鯇
缳	缳 繯
鳇	鳇 鰉
颢	颢 顥
镬	镬 鑊
灏	灏 灝
冱	冱 沍
纮	纮 紘
荭	荭 葒
轷	轷 軤
钬	钬 鈥
袆	袆 褘
晖	晖 暉
龁	龁 齕
婳	婳 嫿
翙	翙 翽
锪	锪 鍃
夥	夥 伙
鹖	鹖 鶡
锽	锽 鍠
锾	锾 鍰
鲘	鲘 鮜
糇	糇 餱
黉	黉 黌
镮	镮 鐶
鹱	鹱 鸌
彟	彟 彠
鳠	鳠 鱯
几	几 幾
见	见 見
仅	仅 僅
计	计 計
讥	讥 譏
击	击 擊
节	节 節
旧	旧 舊
叽	叽 嘰
饥	饥 饑
记	记 記
纠	纠 糾
机	机 機
夹	夹 夾
价	价 價
决	决 決
讲	讲 講
军	军 軍
诀	诀 訣
尽	尽 盡 儘
阶	阶 階
级	级 級
纪	纪 紀
进	进 進
极	极 極
歼	歼 殲
坚	坚 堅
间	间 間
局	局 侷
际	际 際
劲	劲 勁
鸡	鸡 鷄
拣	拣 揀
茎	茎 莖
杰	杰 傑
侥	侥 僥
径	径 徑
剂	剂 劑
净	净 淨
卷	卷 捲
届	届 屆
驾	驾 駕
艰	艰 艱
驹	驹 駒
经	经 經
挤	挤 擠
荆	荆 荊
荐	荐 薦
茧	茧 繭
贱	贱 賤
钧	钧 鈞
俭	俭 儉
剑	剑 劍
饺	饺 餃
将	将 將
奖	奖 奬
迹	迹 跡
姜	姜 薑
洁	洁 潔
浇	浇 澆
济	济 濟
举	举 舉
觉	觉 覺
诫	诫 誡
娇	娇 嬌
结	结 結
骄	骄 驕
绝	绝 絶
绞	绞 絞
捡	捡 撿
晋	晋 晉
轿	轿 轎
较	较 較
监	监 監
紧	紧 緊
钾	钾 鉀
积	积 積
借	借 藉
舰	舰 艦
胶	胶 膠
桨	桨 槳
浆	浆 漿
竞	竞 競
涧	涧 澗
家	家 傢
剧	剧 劇
绢	绢 絹
继	继 繼
骏	骏 駿
据	据 據
检	检 檢
矫	矫 矯
脚	脚 腳
减	减 減
渐	渐 漸
惧	惧 懼
惊	惊 驚
颈	颈 頸
绩	绩 績
搅	搅 攪
蒋	蒋 蔣
颊	颊 頰
践	践 踐
鹃	鹃 鵑
溅	溅 濺
缉	缉 緝
辑	辑 輯
鉴	鉴 鑒
锦	锦 錦
键	键 鍵
锯	锯 鋸
简	简 簡
酱	酱 醬
谨	谨 謹
剿	剿 勦
静	静 靜
槛	槛 檻
碱	碱 鹼 堿
鲫	鲫 鯽
镜	镜 鏡
鲸	鲸 鯨
缰	缰 繮
缴	缴 繳
藉	藉 借
讦	讦 訐
玑	玑 璣
讵	讵 詎
矶	矶 磯
鸠	鸠 鳩
疖	疖 癤
刭	刭 剄
枧	枧 梘
郏	郏 郟
虮	虮 蟣
饯	饯 餞
泾	泾 涇
诘	诘 詰
珏	珏 玨
荚	荚 莢
荠	荠 薺
荩	荩 藎
峤	峤 嶠
胫	胫 脛
浃	浃 浹
浕	浕 濜
绛	绛 絳
觊	觊 覬
笕	笕 筧
隽	隽 雋
痉	痉 痙
阄	阄 鬮
烬	烬 燼
浚	浚 濬
厩	厩 廄
铗	铗 鋏
铰	铰 鉸
笺	笺 箋
谏	谏 諫
皲	皲 皸
靓	靓 靚
颉	颉 頡
赍	赍 賫
睑	睑 瞼
蛱	蛱 蛺
锏	锏 鐧
锔	锔 鋦
飓	飓 颶
颎	颎 熲
裥	裥 襇
缄	缄 緘
蓟	蓟 薊
榉	榉 櫸
龃	龃 齟
跻	跻 躋
锩	锩 錈
缙	缙 縉
缣	缣 縑
戬	戬 戩
霁	霁 霽
鲚	鲚 鱭
鲛	鲛 鮫
馑	馑 饉
谲	谲 譎
觐	觐 覲
镌	镌 鎸
镓	镓 鎵
鲣	鲣 鰹
齑	齑 齏
屦	屦 屨
羁	羁 羈
镢	镢 鐝
鹪	鹪 鷦
鹫	鹫 鷲
鞯	鞯 韉
骥	骥 驥
戋	戋 戔
坰	坰 垧
卺	卺 巹
迳	迳 逕
钜	钜 鉅
赆	赆 贐
桊	桊 棬
琎	琎 璡
鱾	鱾 魢
谫	谫 謭
槚	槚 檟
鲒	鲒 鮚
窭	窭 窶
鲪	鲪 鮶
鹡	鹡 鶺
鹣	鹣 鶼
篯	篯 籛
鳉	鳉 鱂
鳒	鳒 鰜
亏	亏 虧
开	开 開
扣	扣 釦
扩	扩 擴
夸	夸 誇
抠	抠 摳
壳	壳 殻
块	块 塊
克	克 剋
旷	旷 曠
困	困 睏
况	况 況
库	库 庫
矿	矿 礦
昆	昆 崐 崑
凯	凯 凱
垦	垦 墾
捆	捆 梱 綑
宽	宽 寬
课	课 課
恳	恳 懇
铐	铐 銬
馈	馈 饋
阔	阔 闊
溃	溃 潰
裤	裤 褲
窥	窥 窺
颗	颗 顆
邝	邝 鄺
圹	圹 壙
忾	忾 愾
咔	咔 哢
岿	岿 巋
剀	剀 剴
侩	侩 儈
诓	诓 誆
剋	剋 克
轲	轲 軻
眍	眍 瞘
哙	哙 噲
贶	贶 貺
狯	狯 獪
闿	闿 闓
浍	浍 澮
恺	恺 愷
诳	诳 誑
绔	绔 絝
脍	脍 膾
阃	阃 閫
匮	匮 匱
铠	铠 鎧
龛	龛 龕
骒	骒 騍
铿	铿 鏗
颏	颏 頦
愦	愦 憒
喾	喾 嚳
缂	缂 緙
锞	锞 錁
锟	锟 錕
锴	锴 鍇
阚	阚 闞
聩	聩 聵
篑	篑 簣
鲲	鲲 鯤
髋	髋 髖
纩	纩 纊
闶	闶 閌
郐	郐 鄶
垲	垲 塏
钪	钪 鈧
硁	硁 硜
壸	壸 壼
裈	裈 褌
蒉	蒉 蕢
锎	锎 鐦
骙	骙 騤
鹍	鹍 鵾
鲙	鲙 鱠
了	了 瞭
历	历 曆 歷
仑	仑 侖
厉	厉 厲
龙	龙 龍
卢	卢 盧
乐	乐 樂
兰	兰 蘭
礼	礼 禮
辽	辽 遼
吕	吕 呂
伦	伦 倫
刘	刘 劉
论	论 論
抡	抡 掄
芦	芦 蘆
劳	劳 勞
两	两 兩
丽	丽 麗
励	励 勵
来	来 來
连	连 連
卤	卤 滷 鹵
里	里 裏
乱	乱 亂
邻	邻 鄰
疗	疗 療
庐	庐 廬
沥	沥 瀝
沦	沦 淪
灵	灵 靈
陆	陆 陸
驴	驴 驢
拢	拢 攏
拦	拦 攔
垄	垄 壟
轮	轮 輪
虏	虏 虜
咙	咙 嚨
罗	罗 羅
岭	岭 嶺
侣	侣 侶
炉	炉 爐
泪	泪 淚
怜	怜 憐
帘	帘 簾
录	录 録
隶	隶 隸
练	练 練
栏	栏 欄
临	临 臨
览	览 覧
俩	俩 倆
胧	胧 朧
峦	峦 巒
类	类 類
娄	娄 婁
炼	炼 煉
烂	烂 爛
浏	浏 瀏
垒	垒 壘
骆	骆 駱
络	络 絡
捞	捞 撈
莱	莱 萊
莲	莲 蓮
栗	栗 慄
砾	砾 礫
虑	虑 慮
唠	唠 嘮
赂	赂 賂
铃	铃 鈴
赁	赁 賃
留	留 畱
凌	凌 淩
恋	恋 戀
离	离 離
凉	凉 涼
涝	涝 澇
谅	谅 諒
琅	琅 瑯
萝	萝 蘿
聋	聋 聾
辆	辆 輛
颅	颅 顱
累	累 纍
啰	啰 囉
逻	逻 邏
铝	铝 鋁
笼	笼 籠
敛	敛 斂
领	领 領
脸	脸 臉
猎	猎 獵
绿	绿 緑
揽	揽 攬
搂	搂 摟
联	联 聯
棱	棱 稜
雳	雳 靂
睐	睐 睞
链	链 鏈
腊	腊 臘
鲁	鲁 魯
禄	禄 祿
屡	屡 屢
缆	缆 纜
缕	缕 縷
蓝	蓝 藍
榄	榄 欖
楼	楼 樓
赖	赖 賴
龄	龄 齡
锣	锣 鑼
馏	馏 餾
粮	粮 糧
滤	滤 濾
滥	滥 濫
溜	溜 霤
漓	漓 灕
璃	璃 琍
蜡	蜡 蠟
箩	箩 籮
骡	骡 騾
篓	篓 簍
鲤	鲤 鯉
凛	凛 凜
澜	澜 瀾
缭	缭 繚
篮	篮 籃
篱	篱 籬
懒	懒 懶
瞭	瞭 了
镰	镰 鐮
鳞	鳞 鱗
躏	躏 躪
苈	苈 藶
奁	奁 奩
呖	呖 嚦
岚	岚 嵐
囵	囵 圇
钌	钌 釕
陇	陇 隴
纶	纶 綸
垆	垆 壚
茏	茏 蘢
枥	枥 櫪
疠	疠 癘
泷	泷 瀧
泸	泸 瀘
泺	泺 濼
诔	诔 誄
珑	珑 瓏
荦	荦 犖
栊	栊 櫳
栌	栌 櫨
栎	栎 櫟
郦	郦 酈
轳	轳 轤
俪	俪 儷
胪	胪 臚
孪	孪 孿
娈	娈 孌
疬	疬 癧
闾	闾 閭
莅	莅 蒞 涖
逦	逦 邐
砺	砺 礪
砻	砻 礱
辂	辂 輅
鸬	鸬 鸕
眬	眬 矓
崂	崂 嶗
崃	崃 崍
徕	徕 徠
栾	栾 欒
挛	挛 攣
阆	阆 閬
涞	涞 淶
涟	涟 漣
骊	骊 驪
琏	琏 璉
掳	掳 擄
梿	梿 槤
棂	棂 欞
殓	殓 殮
赉	赉 賚
蛎	蛎 蠣
铑	铑 銠
偻	偻 僂
舻	舻 艫
猡	猡 玀
鸾	鸾 鸞
粝	粝 糲
渌	渌 淥
绫	绫 綾
绺	绺 綹
蒌	蒌 蔞
椤	椤 欏
鹂	鹂 鸝
跞	跞 躒
喽	喽 嘍
嵝	嵝 嶁
铼	铼 錸
锂	锂 鋰
锒	锒 鋃
脔	脔 臠
痨	痨 癆
阑	阑 闌
裢	裢 褳
耢	耢 耮
蓠	蓠 蘺
榈	榈 櫚
鲈	鲈 鱸
滦	滦 灤
骝	骝 騮
缡	缡 縭
蔺	蔺 藺
镂	镂 鏤
箓	箓 籙
銮	銮 鑾
瘘	瘘 瘻
潋	潋 瀲
褛	褛 褸
谰	谰 讕
缧	缧 縲
耧	耧 耬
撸	撸 擼
辘	辘 轆
蝼	蝼 螻
噜	噜 嚕
镏	镏 鎦
鲡	鲡 鱺
鲢	鲢 鰱
褴	褴 襤
橹	橹 櫓
辚	辚 轔
镠	镠 鏐
氇	氇 氌
魉	魉 魎
鲮	鲮 鯪
廪	廪 廩
斓	斓 斕
濑	濑 瀨
檩	檩 檁
鹩	鹩 鷯
镣	镣 鐐
镧	镧 鑭
鹭	鹭 鷺
髅	髅 髏
镭	镭 鐳
癞	癞 癩
籁	籁 籟
鳓	鳓 鰳
镴	镴 鑞
鳢	鳢 鱧
坜	坜 壢
轹	轹 轢
昽	昽 曨
俫	俫 倈
哢	哢 咔
鸰	鸰 鴒
梾	梾 棶
稆	稆 穭
脶	脶 腡
辌	辌 輬
铹	铹 鐒
锊	锊 鋝
锍	锍 鋶
溇	溇 漊
裣	裣 襝
蔹	蔹 蘞
飗	飗 飀
鹠	鹠 鶹
澛	澛 瀂
懔	懔 懍
鹨	鹨 鷚
镥	镥 鑥
襕	襕 襴
么	么 麽
门	门 門
马	马 馬
灭	灭 滅
们	们 們
迈	迈 邁
吗	吗 嗎
妈	妈 媽
买	买 買
麦	麦 麥
玛	玛 瑪
亩	亩 畝
闷	闷 悶
没	没 沒
卖	卖 賣
码	码 碼
鸣	鸣 鳴
觅	觅 覓
庙	庙 廟
弥	弥 彌 瀰
面	面 麵
蚂	蚂 螞
骂	骂 駡
脉	脉 脈
贸	贸 貿
闽	闽 閩
秘	秘 祕
悯	悯 憫
梦	梦 夢
铭	铭 銘
猫	猫 貓
谋	谋 謀
谜	谜 謎
绵	绵 綿
蛮	蛮 蠻
缅	缅 緬
蒙	蒙 懞 濛 矇
锚	锚 錨
锰	锰 錳
馍	馍 饃
满	满 滿
谬	谬 謬
蔑	蔑 衊
馒	馒 饅
霉	霉 黴
瞒	瞒 瞞
劢	劢 勱
扪	扪 捫
犸	犸 獁
闵	闵 閔
殁	殁 歿
黾	黾 黽
牦	牦 犛 氂
珉	珉 瑉
荬	荬 蕒
祢	祢 禰
唛	唛 嘜
钼	钼 鉬
铆	铆 鉚
猕	猕 獼
焖	焖 燜
渑	渑 澠
谟	谟 謨
幂	幂 冪
谧	谧 謐
缈	缈 緲
缗	缗 緡
蓦	蓦 驀
鹋	鹋 鶓
腼	腼 靦
谩	谩 謾
镁	镁 鎂
麽	麽 么
鹛	鹛 鶥
缦	缦 縵
缪	缪 繆
颟	颟 顢
螨	螨 蟎
镘	镘 鏝
懑	懑 懣
嬷	嬷 嬤
鳗	鳗 鰻
杩	杩 榪
芈	芈 羋
祃	祃 禡
钔	钔 鍆
祕	祕 秘
湣	湣 愍
愍	愍 湣
镅	镅 鎇
镆	镆 鏌
鹲	鹲 鸏
鳘	鳘 鰵
乃	乃 廼 迺
内	内 內
鸟	鸟 鳥
宁	宁 寧
奶	奶 嬭
农	农 農
拟	拟 擬
纳	纳 納
纽	纽 紐
拧	拧 擰
念	念 唸
狞	狞 獰
疟	疟 瘧
闹	闹 鬧
泞	泞 濘
挠	挠 撓
柠	柠 檸
钠	钠 鈉
钮	钮 鈕
浓	浓 濃
恼	恼 惱
聂	聂 聶
脑	脑 腦
脓	脓 膿
馁	馁 餒
诺	诺 諾
难	难 難
捻	捻 撚
暖	暖 煖
腻	腻 膩
酿	酿 釀
撵	撵 攆
讷	讷 訥
茑	茑 蔦
咛	咛 嚀
钕	钕 釹
侬	侬 儂
驽	驽 駑
哝	哝 噥
铌	铌 鈮
袅	袅 裊
啮	啮 嚙
铙	铙 鐃
秾	秾 穠
辇	辇 輦
蛲	蛲 蟯
傩	傩 儺
嗫	嗫 囁
鲇	鲇 鮎
镊	镊 鑷
镍	镍 鎳
颞	颞 顳
鲵	鲵 鯢
蹑	蹑 躡
馕	馕 饢
垴	垴 堖
迺	迺 乃
陧	陧 隉
聍	聍 聹
锘	锘 鍩
镎	镎 鎿
呕	呕 嘔
欧	欧 歐
殴	殴 毆
鸥	鸥 鷗
讴	讴 謳
沤	沤 漚
怄	怄 慪
瓯	瓯 甌
仆	仆 僕
扑	扑 撲
朴	朴 樸
抛	抛 拋
评	评 評
苹	苹 蘋
凭	凭 憑
佩	佩 珮
贫	贫 貧
庞	庞 龐
泼	泼 潑
炮	炮 砲
盘	盘 盤
颇	颇 頗
喷	喷 噴
赔	赔 賠
铺	铺 鋪
骗	骗 騙
频	频 頻
鹏	鹏 鵬
谱	谱 譜
飘	飘 飄
爿	爿 丬
钋	钋 釙
彷	彷 徬
纰	纰 紕
狍	狍 麅
骈	骈 駢
铍	铍 鈹
疱	疱 皰
谝	谝 諞
鲆	鲆 鮃
嫔	嫔 嬪
辔	辔 轡
罴	罴 羆
骠	骠 驃
缥	缥 縹
蹒	蹒 蹣
颦	颦 顰
钷	钷 鉕
酦	酦 醱
锫	锫 錇
鲏	鲏 鮍
镤	镤 鏷
镨	镨 鐠
鳑	鳑 鰟
千	千 韆
区	区 區
气	气 氣
劝	劝 勸
权	权 權
曲	曲 麯
岂	岂 豈
迁	迁 遷
乔	乔 喬
庆	庆 慶
齐	齐 齊
抢	抢 搶
却	却 卻
呛	呛 嗆
岖	岖 嶇
弃	弃 棄
穷	穷 窮
启	启 啓
驱	驱 驅
枪	枪 槍
顷	顷 頃
侨	侨 僑
浅	浅 淺
牵	牵 牽
轻	轻 輕
钦	钦 欽
氢	氢 氫
秋	秋 鞦
亲	亲 親
窃	窃 竊
栖	栖 棲
桥	桥 橋
钱	钱 錢
钳	钳 鉗
铅	铅 鉛
倾	倾 傾
脐	脐 臍
凄	凄 淒
窍	窍 竅
请	请 請
乾	乾 干
戚	戚 慼
躯	躯 軀
骑	骑 騎
琼	琼 瓊
趋	趋 趨
期	期 朞
确	确 確
翘	翘 翹
谦	谦 謙
强	强 強
鹊	鹊 鵲
跷	跷 蹺
签	签 簽 籤
寝	寝 寢
墙	墙 墻
锹	锹 鍬
旗	旗 旂
潜	潜 潛
谴	谴 譴
鳍	鳍 鰭
讫	讫 訖
扦	扦 扡
虬	虬 虯
吣	吣 唚
佥	佥 僉
苘	苘 檾
茕	茕 煢
钎	钎 釺
郄	郄 郤
戗	戗 戧
炝	炝 熗
诠	诠 詮
荞	荞 蕎
荨	荨 蕁
钤	钤 鈐
诮	诮 誚
桤	桤 榿
颀	颀 頎
鸲	鸲 鴝
悭	悭 慳
骎	骎 駸
悫	悫 慤
硗	硗 磽
堑	堑 塹
跄	跄 蹌
赇	赇 賕
铨	铨 銓
羟	羟 羥
惬	惬 愜
骐	骐 騏
绮	绮 綺
绻	绻 綣
揿	揿 撳
椠	椠 槧
蛴	蛴 蠐
舄	舄 潟
阒	阒 闃
阕	阕 闋
巯	巯 巰
碛	碛 磧
锜	锜 錡
鹐	鹐 鵮
阙	阙 闕
骞	骞 騫
蔷	蔷 薔
蜷	蜷 踡
锲	锲 鍥
锵	锵 鏘
箧	箧 篋
谯	谯 譙
嫱	嫱 嬙
鞒	鞒 鞽
蕲	蕲 蘄
樯	樯 檣
觑	觑 覷
缱	缱 繾
缲	缲 繰
龋	龋 齲
镪	镪 鏹
鳅	鳅 鰍
襁	襁 繈 繦
颧	颧 顴
癯	癯 臒
伣	伣 俔
诎	诎 詘
玱	玱 瑲
肷	肷 膁
辁	辁 輇
硚	硚 礄
庼	庼 廎
棬	棬 桊
嵚	嵚 嶔
锓	锓 鋟
锖	锖 錆
鹙	鹙 鶖
麹	麹 麴
鲭	鲭 鯖
鲯	鲯 鯕
鳈	鳈 鰁
认	认 認
让	让 讓
纫	纫 紉
韧	韧 韌
扰	扰 擾
闰	闰 閏
软	软 軟
荣	荣 榮
饶	饶 饒
绒	绒 絨
绕	绕 繞
热	热 熱
润	润 潤
锐	锐 鋭
轫	轫 軔
饪	饪 飪
纴	纴 紝
娆	娆 嬈
桡	桡 橈
铷	铷 銣
嵘	嵘 嶸
缛	缛 縟
蝾	蝾 蠑
讱	讱 訒
驲	驲 馹
荛	荛 蕘
镕	镕 鎔
颥	颥 顬
尸	尸 屍
升	升 陞
双	双 雙
书	书 書
术	术 術
帅	帅 帥
闪	闪 閃
圣	圣 聖
丝	丝 絲
扫	扫 掃
师	师 師
岁	岁 歲
伤	伤 傷
杀	杀 殺
伞	伞 傘
讼	讼 訟
设	设 設
孙	孙 孫
寿	寿 壽
声	声 聲
苏	苏 囌 蘇
时	时 時
删	删 刪
沈	沈 瀋
识	识 識
诉	诉 訴
纱	纱 紗
势	势 勢
枢	枢 樞
松	松 鬆
丧	丧 喪
肾	肾 腎
舍	舍 捨
饰	饰 飾
饲	饲 飼
审	审 審
实	实 實
试	试 試
诗	诗 詩
视	视 視
肃	肃 肅
陕	陕 陝
绅	绅 紳
驶	驶 駛
绍	绍 紹
树	树 樹
竖	竖 竪
虽	虽 雖
适	适 適
顺	顺 順
胜	胜 勝
狮	狮 獅
蚀	蚀 蝕
烁	烁 爍
洒	洒 灑
说	说 説
诵	诵 誦
损	损 損
晒	晒 曬
笋	笋 筍
耸	耸 聳
颂	颂 頌
烧	烧 燒
涩	涩 澀
谁	谁 誰
琐	琐 瑣
萨	萨 薩
硕	硕 碩
兽	兽 獸
渗	渗 滲
随	随 隨
婶	婶 嬸
绳	绳 繩
厦	厦 廈
赏	赏 賞
赎	赎 贖
锁	锁 鎖
剩	剩 賸
税	税 稅
筛	筛 篩
释	释 釋
湿	湿 濕
属	属 屬
骚	骚 騷
摄	摄 攝
输	输 輸
数	数 數
溯	溯 泝
酸	酸 痠
赛	赛 賽
缩	缩 縮
鲨	鲨 鯊
赡	赡 贍
闩	闩 閂
讪	讪 訕
厍	厍 厙
佘	佘 畲
纾	纾 紓
咝	咝 噝
怂	怂 慫
诜	诜 詵
姗	姗 姍
驷	驷 駟
垧	垧 坰
贳	贳 貰
荪	荪 蓀
殇	殇 殤
狲	狲 猻
飒	飒 颯
埘	埘 塒
莳	莳 蒔
轼	轼 軾
唢	唢 嗩
铄	铄 鑠
铈	铈 鈰
谂	谂 諗
谇	谇 誶
绥	绥 綏
鸶	鸶 鷥
啬	啬 嗇
赊	赊 賒
铩	铩 鎩
铯	铯 銫
绱	绱 緔
绶	绶 綬
蛳	蛳 螄
畲	畲 佘
觞	觞 觴
馊	馊 餿
谡	谡 謖
谥	谥 謚
缌	缌 緦
摅	摅 攄
稣	稣 穌
飕	飕 颼
瘆	瘆 瘮
慑	慑 懾
骟	骟 騸
厮	厮 廝
锶	锶 鍶
糁	糁 糝
缫	缫 繅
鲥	鲥 鰣
馓	馓 饊
缮	缮 繕
擞	擞 擻
薮	薮 藪
穑	穑 穡
颡	颡 顙
鳃	鳃 鰓
鳝	鳝 鱔
钐	钐 釤
鸤	鸤 鳲
浉	浉 溮
陞	陞 升
骕	骕 驌
毵	毵 毿
飔	飔 颸
滠	滠 灄
鹔	鹔 鷫
酾	酾 釃
锼	锼 鎪
鲺	鲺 鯴
鲹	鲹 鰺 鯵
骦	骦 驦
鹴	鹴 鸘
厅	厅 廳
叹	叹 嘆
头	头 頭
讨	讨 討
台	台 檯 颱 臺
团	团 團 糰
汤	汤 湯
驮	驮 馱
坛	坛 壇 罎
听	听 聽
秃	秃 禿
体	体 體
条	条 條
抬	抬 擡
态	态 態
图	图 圖
贪	贪 貪
屉	屉 屜
驼	驼 駝
贴	贴 貼
统	统 統
铁	铁 鐡
鸵	鸵 鴕
涛	涛 濤
涂	涂 塗
烫	烫 燙
调	调 調
谈	谈 談
铜	铜 銅
偷	偷 偸 媮
脱	脱 脫
椭	椭 橢
摊	摊 攤
蜕	蜕 蛻
颓	颓 頽
腾	腾 騰
誊	誊 謄
滩	滩 灘
谭	谭 譚
题	题 題
瘫	瘫 癱
抟	抟 摶
饨	饨 飩
昙	昙 曇
沓	沓 遝
钍	钍 釷
骀	骀 駘
挞	挞 撻
钛	钛 鈦
闼	闼 闥
烃	烃 烴
恸	恸 慟
钽	钽 鉭
铊	铊 鉈
绦	绦 縧
绨	绨 綈
眺	眺 覜
铤	铤 鋌
粜	粜 糶
锑	锑 銻
傥	傥 儻
鲀	鲀 魨
鹈	鹈 鵜
缇	缇 緹
鲐	鲐 鮐
阗	阗 闐
韬	韬 韜
镗	镗 鏜
獭	獭 獺
鳀	鳀 鯷
鳎	鳎 鰨
鼍	鼍 鼉
萚	萚 蘀
啴	啴 嘽
铴	铴 鐋
绹	绹 綯
铽	铽 鋱
颋	颋 頲
龆	龆 齠
锬	锬 錟
阘	阘 闒
箨	箨 籜
鲖	鲖 鮦
镋	镋 钂
鲦	鲦 鰷
鼗	鼗 鞉 鞀
万	万 萬
卫	卫 衛
无	无 無
乌	乌 烏
为	为 爲
务	务 務
网	网 網
伟	伟 偉
伪	伪 僞
问	问 問
污	污 汙
违	违 違
芜	芜 蕪
苇	苇 葦
吴	吴 吳
围	围 圍
呜	呜 嗚
纬	纬 緯
纹	纹 紋
卧	卧 臥
弯	弯 彎
闻	闻 聞
洼	洼 窪
诬	诬 誣
误	误 誤
顽	顽 頑
涡	涡 渦
袜	袜 襪
谓	谓 謂
维	维 維
猬	猬 蝟
温	温 溫
湾	湾 灣
窝	窝 窩
鹉	鹉 鵡
雾	雾 霧
蜗	蜗 蝸
稳	稳 穩
韦	韦 韋
邬	邬 鄔
纨	纨 紈
坞	坞 塢
帏	帏 幃
庑	庑 廡
闱	闱 闈
沩	沩 潙
怃	怃 憮
妩	妩 嫵
玮	玮 瑋
瓮	瓮 甕
炜	炜 煒
钨	钨 鎢
莴	莴 萵
涠	涠 潿
诿	诿 諉
娲	娲 媧
绾	绾 綰
塆	塆 壪
辋	辋 輞
铻	铻 鋙
骛	骛 騖
韪	韪 韙
鲔	鲔 鮪
潍	潍 濰
鹜	鹜 鶩
龌	龌 齷
呙	呙 咼
硙	硙 磑
阌	阌 閿
鹀	鹀 鵐
辒	辒 輼
腽	腽 膃
鹟	鹟 鶲
鳁	鳁 鰛
鳂	鳂 鰃
习	习 習
乡	乡 鄉
凶	凶 兇
写	写 寫
训	训 訓
讯	讯 訊
协	协 協
吁	吁 籲
吓	吓 嚇
向	向 嚮
兴	兴 興
许	许 許
寻	寻 尋
戏	戏 戲
纤	纤 縴 纖
驯	驯 馴
轩	轩 軒
县	县 縣
系	系 係 繫
闲	闲 閑
汹	汹 洶
现	现 現
贤	贤 賢
侠	侠 俠
欣	欣 訢
胁	胁 脅
泻	泻 瀉
学	学 學
询	询 詢
详	详 詳
线	线 綫
细	细 細
项	项 項
挟	挟 挾
咸	咸 鹹
显	显 顯
虾	虾 蝦
勋	勋 勛
响	响 響
峡	峡 峽
选	选 選
修	修 脩
须	须 須 鬚
叙	叙 敘
狭	狭 狹
恤	恤 卹 賉
宪	宪 憲
逊	逊 遜
险	险 險
绚	绚 絢
晓	晓 曉
牺	牺 犧
席	席 蓆
效	效 傚
绣	绣 綉
萧	萧 蕭
厢	厢 廂
袭	袭 襲
虚	虚 虛
悬	悬 懸
啸	啸 嘯
衅	衅 釁
衔	衔 銜
馅	馅 餡
旋	旋 鏇
谐	谐 諧
绪	绪 緒
续	续 續
销	销 銷
锈	锈 銹
锌	锌 鋅
羡	羡 羨
谢	谢 謝
携	携 攜
献	献 獻
锡	锡 錫
溪	溪 谿
辖	辖 轄
熏	熏 薰 燻
箫	箫 簫
鲜	鲜 鮮
潇	潇 瀟
蝎	蝎 蠍
嚣	嚣 囂
癣	癣 癬
镶	镶 鑲
芗	芗 薌
饧	饧 餳
苋	苋 莧
岘	岘 峴
饩	饩 餼
陉	陉 陘
枭	枭 梟
诩	诩 詡
绁	绁 紲
挦	挦 撏
荥	荥 滎
哓	哓 嘵
郤	郤 郄
饷	饷 餉
籼	籼 秈
浔	浔 潯
骁	骁 驍
顼	顼 頊
埙	埙 塤
鸮	鸮 鴞
蚬	蚬 蜆
铉	铉 鉉
玺	玺 璽
猃	猃 獫
娴	娴 嫻
绡	绡 綃
觋	觋 覡
硖	硖 硤
勖	勖 勗
铣	铣 銑
阋	阋 鬩
谑	谑 謔
谖	谖 諼
媭	媭 嬃
亵	亵 褻
痫	痫 癇
鹇	鹇 鷴
溆	溆 漵
缃	缃 緗
飨	飨 饗
酰	酰 醯
跹	跹 躚
锨	锨 鍁
馐	馐 饈
嘘	嘘 噓
鲟	鲟 鱘
鲞	鲞 鮝
璇	璇 璿
撷	撷 擷
潟	潟 舄
缬	缬 纈
薰	薰 熏
藓	藓 蘚
镡	镡 鐔
醯	醯 酰
鳕	鳕 鱈
骧	骧 驤
讻	讻 訩
诇	诇 詗
屃	屃 屓
狝	狝 獮
峃	峃 嶨
钘	钘 鈃
饻	饻 餏
莶	莶 薟
崄	崄 嶮
脩	脩 修
绤	绤 綌
骍	骍 騂
铏	铏 鉶
鸺	鸺 鵂
谞	谞 諝
敩	敩 斆
缐	缐 線
碹	碹 镟
蟏	蟏 蠨
谿	谿 溪
鳛	鳛 鰼
于	于 於
与	与 與
亿	亿 億
义	义 義
云	云 雲
艺	艺 藝
匀	匀 勻
忆	忆 憶
轧	轧 軋
业	业 業
叶	叶 葉
仪	仪 儀
议	议 議
扬	扬 揚
亚	亚 亞
压	压 壓
厌	厌 厭
页	页 頁
尧	尧 堯
屿	屿 嶼
优	优 優
爷	爷 爺
讶	讶 訝
异	异 異
阳	阳 陽
阴	阴 陰
约	约 約
远	远 遠
运	运 運
严	严 嚴
杨	杨 楊
医	医 醫
园	园 園
邮	邮 郵
员	员 員
佑	佑 祐
佣	佣 傭
余	余 餘
犹	犹 猶
饮	饮 飲
应	应 應
忧	忧 憂
译	译 譯
拥	拥 擁
郁	郁 鬰
咏	咏 詠
岩	岩 喦 巖
岳	岳 嶽
鱼	鱼 魚
绎	绎 繹
荧	荧 熒
荫	荫 蔭
药	药 藥
砚	砚 硯
鸦	鸦 鴉
哑	哑 啞
蚁	蚁 蟻
哟	哟 喲
贻	贻 貽
钥	钥 鑰
狱	狱 獄
养	养 養
语	语 語
诱	诱 誘
陨	陨 隕
艳	艳 艷
盐	盐 鹽
莹	莹 瑩
莺	莺 鶯
样	样 樣
鸭	鸭 鴨
晕	晕 暈
鸯	鸯 鴦
圆	圆 圓
鸳	鸳 鴛
阅	阅 閲
烟	烟 煙 菸
涌	涌 湧
悦	悦 悅
谊	谊 誼
娱	娱 娛
预	预 預
验	验 驗
萤	萤 螢
营	营 營
酝	酝 醖
跃	跃 躍
婴	婴 嬰
银	银 銀
痒	痒 癢
阎	阎 閻
渊	渊 淵
淫	淫 婬
渔	渔 漁
窑	窑 窯 窰
谚	谚 諺
隐	隐 隱
遗	遗 遺
粤	粤 粵
御	御 禦
游	游 遊
谣	谣 謡
缘	缘 緣
摇	摇 搖
愈	愈 瘉
遥	遥 遙
颖	颖 穎
韵	韵 韻
誉	誉 譽
愿	愿 願
踊	踊 踴
蝇	蝇 蠅
舆	舆 輿
演	演 縯
蕴	蕴 藴
樱	樱 櫻
颜	颜 顔
鹦	鹦 鸚
瘾	瘾 癮
檐	檐 簷
赢	赢 贏
鹰	鹰 鷹
耀	耀 燿
驭	驭 馭
钇	钇 釔
伛	伛 傴
纡	纡 紆
玙	玙 璵
芸	芸 蕓
欤	欤 歟
邺	邺 鄴
呓	呓 囈
旸	旸 暘
饫	饫 飫
炀	炀 煬
诒	诒 詒
妪	妪 嫗
纭	纭 紜
茔	茔 塋
鸢	鸢 鳶
峄	峄 嶧
饴	饴 飴
疡	疡 瘍
兖	兖 兗
怿	怿 懌
郓	郓 鄆
祎	祎 禕
诣	诣 詣
驿	驿 驛
垭	垭 埡
轶	轶 軼
哕	哕 噦
郧	郧 鄖
峣	峣 嶢
俨	俨 儼
俣	俣 俁
彦	彦 彥
恹	恹 懨
恽	恽 惲
娅	娅 婭
莜	莜 蓧
莸	莸 蕕
钰	钰 鈺
钺	钺 鉞
铀	铀 鈾
氩	氩 氬
痈	痈 癰
訚	訚 誾
烨	烨 燁
谀	谀 諛
萦	萦 縈
殒	殒 殞
铟	铟 銦
铱	铱 銥
阈	阈 閾
阉	阉 閹
谒	谒 謁
谕	谕 諭
鼋	鼋 黿
嵛	嵛 崳
鹆	鹆 鵒
鱿	鱿 魷
颍	颍 潁
愠	愠 慍
韫	韫 韞
蓥	蓥 鎣
颐	颐 頤
氲	氲 氳
觎	觎 覦
滟	滟 灧
滢	滢 瀅
滪	滪 澦
缢	缢 縊
瑶	瑶 瑤
撄	撄 攖
墉	墉 鄘
酽	酽 釅
辕	辕 轅
龈	龈 齦
嘤	嘤 嚶
罂	罂 罌
缨	缨 纓
璎	璎 瓔
靥	靥 靨
魇	魇 魘
餍	餍 饜
龉	龉 齬
颙	颙 顒
镒	镒 鎰
鹞	鹞 鷂
谳	谳 讞
橼	橼 櫞
赝	赝 贋
镛	镛 鏞
赟	赟 贇
瘿	瘿 癭
鹬	鹬 鷸
鳐	鳐 鰩
彝	彝 彞
鳙	鳙 鱅
鼹	鼹 鼴
闫	闫 閆
觃	觃 覎
飏	飏 颺
钖	钖 鍚
於	於 于
轺	轺 軺
舣	舣 艤
祐	祐 佑
骃	骃 駰
桠	桠 椏
晔	晔 曄
涢	涢 溳
勚	勚 勩
厣	厣 厴
铕	铕 銪
铘	铘 鋣
龂	龂 齗
溁	溁 濚
缊	缊 緼
蓣	蓣 蕷
锳	锳 鍈
筼	筼 篔
鲉	鲉 鮋
馌	馌 饁
鄘	鄘 墉
瘗	瘗 瘞
潆	潆 瀠
鹝	鹝 鷊
慭	慭 憖
鲬	鲬 鯒
鹢	鹢 鷁
黡	黡 黶
镱	镱 鐿
专	专 專
扎	扎 紮 紥
占	占 佔
只	只 隻
执	执 執
贞	贞 貞
则	则 則
朱	朱 硃
众	众 衆
杂	杂 雜
争	争 爭
壮	壮 壯
妆	妆 妝
庄	庄 莊
阵	阵 陣
折	折 摺
帐	帐 帳
针	针 針
状	状 狀
这	这 這
灶	灶 竈
灾	灾 災
证	证 證
诈	诈 詐
诊	诊 診
张	张 張
坠	坠 墜
纵	纵 縱
纸	纸 紙
责	责 責
择	择 擇
枣	枣 棗
转	转 轉
斩	斩 斬
帜	帜 幟
账	账 賬
贮	贮 貯
制	制 製
侄	侄 姪
侦	侦 偵
质	质 質
征	征 徵
肿	肿 腫
胀	胀 脹
闸	闸 閘
郑	郑 鄭
泽	泽 澤
组	组 組
织	织 織
终	终 終
驻	驻 駐
赵	赵 趙
挣	挣 掙
栈	栈 棧
栅	栅 柵
砖	砖 磚
轴	轴 軸
战	战 戰
咱	咱 偺 喒
钟	钟 鐘 鍾
毡	毡 氈
种	种 種
狰	狰 猙
咨	咨 諮
兹	兹 茲 玆
总	总 總
浊	浊 濁
昼	昼 晝
盏	盏 盞
载	载 載
挚	挚 摯
桩	桩 樁
致	致 緻
贼	贼 賊
赃	赃 贓
钻	钻 鑽
债	债 債
脏	脏 髒 臟
皱	皱 皺
准	准 凖
症	症 癥
斋	斋 齋
资	资 資
烛	烛 燭
涨	涨 漲
诸	诸 諸
谆	谆 諄
掷	掷 擲
职	职 職
著	著 着
睁	睁 睜
崭	崭 嶄
猪	猪 豬
着	着 著
综	综 綜
绽	绽 綻
缀	缀 綴
暂	暂 暫
凿	凿 鑿
铸	铸 鑄
筑	筑 築
筝	筝 箏
装	装 裝
滞	滞 滯
照	照 炤
锥	锥 錐
赘	赘 贅
榨	榨 搾
辗	辗 輾
赚	赚 賺
踪	踪 蹤
嘱	嘱 囑
镇	镇 鎮
辙	辙 轍
赠	赠 贈
赞	赞 贊
瞩	瞩 矚
骤	骤 驟
札	札 劄
伫	伫 佇
纣	纣 紂
苎	苎 苧
钊	钊 釗
邹	邹 鄒
诅	诅 詛
诌	诌 謅
诏	诏 詔
诛	诛 誅
诤	诤 諍
绉	绉 縐
挝	挝 撾
荮	荮 葤
栉	栉 櫛
栀	栀 梔
轸	轸 軫
咤	咤 吒
帧	帧 幀
峥	峥 崢
鸩	鸩 鴆
贽	贽 贄
桢	桢 楨
轾	轾 輊
唣	唣 唕
钲	钲 鉦
诹	诹 諏
冢	冢 塚
诼	诼 諑
祯	祯 禎
鸷	鸷 鷙
辄	辄 輒
眦	眦 眥
啧	啧 嘖
啭	啭 囀
帻	帻 幘
赈	赈 賑
铡	铡 鍘
铢	铢 銖
铮	铮 錚
偬	偬 傯
渍	渍 漬
骓	骓 騅
缁	缁 緇
揸	揸 摣
蛰	蛰 蟄
棹	棹 櫂
辎	辎 輜
跖	跖 蹠
锃	锃 鋥
骘	骘 騭
缒	缒 縋
锗	锗 鍺
锱	锱 錙
谪	谪 謫
缜	缜 縝
槠	槠 櫧
龇	龇 齜
箦	箦 簀
潴	潴 瀦
谮	谮 譖
赜	赜 賾
踬	踬 躓
踯	踯 躑
颛	颛 顓
徵	徵 征
觯	觯 觶
馔	馔 饌
谵	谵 譫
缯	缯 繒
錾	錾 鏨
镞	镞 鏃
鲻	鲻 鯔
鹧	鹧 鷓
镯	镯 鐲
攒	攒 攢
缵	缵 纘
瓒	瓒 瓚
臜	臜 臢
鳟	鳟 鱒
趱	趱 趲
躜	躜 躦
吒	吒 咤
纻	纻 紵
纼	纼 紖
苧	苧 苎
驵	驵 駔
驺	驺 騶
轵	轵 軹
飐	飐 颭
浈	浈 湞
辀	辀 輈
赀	赀 貲
铚	铚 銍
鸼	鸼 鵃
絷	絷 縶
詟	詟 讋
赒	赒 賙
锧	锧 鑕
鲊	鲊 鮓
镃	镃 鎡
劄	劄 札
鲗	鲗 鰂
鲝	鲝 鮺
橥	橥 櫫
鲰	鲰 鯫
鹯	鹯 鸇
鳣	鳣 鱣
齇	齇 齄
